  #####
 ##   #
# $ # #
# #  . #
#    # #
 # #   #
 #@  ## 
 #####  
