#######
#*    #
# $ . #
#  @  #
#######
