     #### 
 #####  # 
 #      # 
## # ##$# 
#  # @. #
#  .$ # ##
## ##.#  #
 #    $  #
 #  ######
 ####     
