########
#   *  #
#@.*** #
##  $  #
 ##   ##
  ##  # 
   #### 
